#...#
#...#
#...#
#.###
#..##
##..#
#...#
#.#.#
#...#
#...#
##.##
##.##
##.##
#...#
.....
..P..
